estimates: A rough calculation or assessment of the value, size, or cost of something.
differ: Not to have the same traits or characteristics; to be unalike or distinct.
vibrant: Pulsing with energy or activity.
despite: ---
affluent: Abundant; copious; plenteous.
spatial: Pertaining to (the dimension of) space.
such as: ---
developing countries: A poorer country which is seeking to expand its economy.
sevenfold: By a factor of seven.
prosperous: Characterized by success
gentrification: (urban studies) The renewal and rebuilding that accompanies the influx of middle class or affluent people into deteriorating areas and often displaces earlier, usually poorer, residents; any example of such a process.
commuters: One who commutes (etymology 1).
destitute: ---
separation: The act of disuniting two or more things, or the condition of being separated.
fragile: Easily broken or destroyed, and thus often of subtle or intricate structure.
entity: That which has a distinct existence as an individual unit. Often used for organisations which have no physical form.
inevitable: Impossible to avoid or prevent.
city-dwellers: ---
require: To ask (someone) for something; to request.
sanitary facilities: ---
precarious: Dangerously insecure or unstable; perilous.
sewage treatment plants: ---
developed countries: ---
deteriorating: Getting worse
lack: To be without, to need, to require.
meet the demands: ---
deprive of: ---
makeshift: A temporary (usually insubstantial) substitution.
plywood: Construction material supplied in sheets, and made of three or more layers of wood veneer glued together, laid up with alternating layers having their grain perpendicular to each other.
rural: Relating to the countryside or to agriculture.
residents: A person, animal or plant living at a certain location or in a certain area.
urban cores: ---
sprawl: An ungainly sprawling posture.
economic segregation: ---
social segregation: ---
there is a cost to: ---
inextricably: In an inextricable manner.
